****X*X****X*X*X**X*X****XX******X***X******X*****
X*XX****XX*X****X****XXX****XX*X***XX**X*X*X**X*X*
*****XXX***X*XX***XX***XXX*X****X*XX**X***XX*X*X**
*XXXX***X*X**X*X*X*XXX****X**X*X*X***XXX*X***X***X
*X****X*X**X****X*****XXX*XXX**X***XX*X**X*XX**X**
X**XX*X**X*X*X*X**XXX***X****X*X*XX***X*XX*X*X**X*
**X***X*X**X*X**X*X**XX**XXX*X******X*X*X**X**X*X*
*X**X*X*X*X**XX*X***XXXX***X*XX*XXX**X**X*XXX*X**X
*X*X***XX*X*X***X*X**XX**X*X***X***X*X*XX**XX**X**
**X**X*X**X*X*XXX**XX***X**XXX*XX*X**X***X****XX*X
X**X*X***X*X**X***X***X**X***X**X***X*XX**X*X*X***
*X**X*XXX****X**XXX*XX*XX**XX*X*X*XX**X**X***XX*X*
*X*X**X***XXX*XXX***X*****X*****X*X**XX*X**XX***X*
*X***X**XXX*X*****XX*X*X*XX*XX*X****X****X*X**XX**
*XXX***X******X*XX***X**X***X*X**XX*X*X*X***X*X*X*
****X*X*X*XX*X*X***X**X*X*XX****X**XX**X**X*X****X
X*XX*X******X****X**X*X*X**X*XXX*X***X*X*XXX*XXX**
**X****XXXX**X*X**X**X***X**XX*****X*X****X*****X*
*X**X*X****X*X**XX**X**XX*X*X**X*XXX**XXX*X*X*X***
***XXX*XXX*X**X**X*X**X***X***X*X***X***X*X**X*XX*
*XX*X****X**X*XX*X**X**X*X*XXX**X*X**XX**XXX****XX
*X****XX*X*XX**X**X**X*X******X***X*XXXX**X**XX***
**X*XX*X***X*X**X**X*****X*XX**X*X***XX**X**X***X*
X***X***X*X**X*X**X*X*X*X*X**X*X**X*X***X**X*X*X**
*X*XXX*XX*X*XX**XX***X*X****X***X*X***XX**X***X**X
**X*X**X**X*X*X*X**X*X**X*X***XXX**XXX*X*X**X***X*
*X***X***X****X**X*X**X****XXX****X****X*XX**XX***
*X*X**X*X**X*X*X***XX*XX*X*X*X*XXX**XX*X**XX**XXXX
***XX*X**XX****XX*X*X***X****X****X*XX**X**XX*****
X*X*X**X**X*XX***X***XX*X*X*X**X*X****X**X***XXXX*
****XX**X*X***X*X**XX*X**X***XX***X*X*XXX**X****X*
XXXX***X***XX**X**X***X*X**XX***XX**X****X**XX*X**
*****X**X*X***X**X**X*X**X**X*X*X**X*XXX**X**XXX*X
*XXX**XXX*X*X***XX*XX**X**X*X**X**XX****X***X*****
*X***X****X*XX*X***X*X*XX*XX*X**X****X*X*X*X**XXX*
**XXX**X*X****X**XX**X**X*****X**X*X**X***X**X**X*
X***X*XXX*X*X***XX*X**X**XX*X*X*X***XX**X*X*X*X*X*
X*X*X*XX***X**XXX****XXX**X*XX***XXX***XX***X***X*
**X*X****X*X*X****XX**XX*XX***XX***X*X*X*XXX**XX**
*XX**XXXX**X***XXX***X***X*XX***XX***XX******XX**X
***X*****X**X*X***XX*X*X*X***X*X*XXXX***X*XX*X**X*
X*XXXXXX*X*X*X**X***XX*X*X*X*X********XX***XX**X**
***X***X*X*X*X*X*XX****X*X*X**X*XXX*XX***XX***XX*X
XXX**X*X*X*X***X***XXXX**X*X*X**X*X***XXX***XX***X
****X****X**X*XX*X****X*X**X**XX***X*X***XX*X**X**
*X*X*XXX**X*X*X**XXXX*X*X*X*X****X*X***X****X*XXX*
*XX*****X*X*X*X*X***X***XX***X*XXX**XXX*XXXX***X**
****XXX**X**X*X*X*X**XXX***X***X**X***X*****XX**X*
*XXXX**X*X*XX*X**XX*X***X*X*XXX*X*X*X**XX*X***X*X*
******X********X******X***X**********X****X*X***X*
