25,15
***X*****X*XXX*******X***
*XXXXX*XXX*XXX*XXX*XXXXX*
***X***X***X*X*X***X*X***
XX*XXX*X*XXX*XXX*X*X*X*X*
*X*************X*X*****X*
*X*XXX*XXXXXXX*X*XXX*X*XX
***X*****X*******XXX*X***
*X*X*X*XXXXXXX*XXXXXXXXX*
*X*X*X*XXXXXXX*X*********
*XXXXXXXXXXXXXXX*XXXXXXXX
*XXXXXXXXXXXXXXX*XXXXX***
XXXXXXXXXXXXXXXX*XXXXX*X*
XXXXXXXXXXXXXX***XXXXX*X*
XXXXXXXXXXXXXX*XXXXXXX*X*
XXXXXXXXXX*************X*