*X***********X*****X*****
*XXXXX*X*X*XXX*XXX*X*XXX*
***X***X*X*******X*X*X***
XX*XXX*X*X*XXX*X*X*XXXXX*
XX***X*X*X*X*X*X*X***X***
XXXX*XXX*XXX*XXXXXXX*X*X*
XXXX***X*******X*X*X***X*
XXXXXX*XXX*X*XXX*X*XXX*XX
XXXXXX***X*X***X*****X*XX
XXXXXX*XXXXXXX*X*XXX*X*XX
XXXXXX***X*****X***X*X*XX
XXXXXX*XXX*XXX*X*X*XXX*XX
XXXXXX*******X*X*X*X***XX
XXXXXXXX*XXX*XXXXX*X*XXXX
XXXXXXXX***X*XXX*********