25,15
******X****X***X******X**
********X*X****XXX******X
*****XXX****XX***X*******
*******X***X**X**********
**X*X****XXX**XXXX*******
*X*X*XXXX*********X******
****XX**X**X**X**X*X*****
X********XXXX**XXX**X*X**
***X*X**X**X**X****XX****
*X**XX*XX*X*****X****X***
******X*X**************X*
XX*X*X**X****************
*****X*X*******XX*XXX****
*********X****X*****X****
*****X****X****XX*XX*X***